NO ./textures/stone_wall.xpm
WE ./textures/wall_1.xpm
SO ./textures/stone_wall2.xpm
EA ./textures/eagle.xpmm

F 75,108,87
C 173,216, 230

111111111111111111111
110010000010000000011
100000000000000000001
111000000 00001001101
101000000000100000001
100000001000000000001
10000000000000000 001
10000E000000000000001
111111111111111111111
